m	ﾝ
n	ﾝ
k	ｯ
g	ｯ
s	ｯ
z	ｯ
j	ｯ
t	ｯ
c	ｯ
d	ｯ
h	ｯ
b	ｯ
p	ｯ
f	ｯ
y	ｯ
r	ｯ
w	ｯ
v	ｯ
xa	ｧ
a	ｱ
xi	ｨ
i	ｲ
xu	ｩ
u	ｳ
whu	ｳ
wha	ｳｧ
whi	ｳｨ
whe	ｳｪ
who	ｳｫ
xe	ｪ
e	ｴ
xo	ｫ
o	ｵ
ka	ｶ
ga	ｶﾞ
ki	ｷ
kyi	ｷｨ
kye	ｷｪ
kya	ｷｬ
kyu	ｷｭ
kyo	ｷｮ
gi	ｷﾞ
gyi	ｷﾞｨ
gye	ｷﾞｪ
gya	ｷﾞｬ
gyu	ｷﾞｭ
gyo	ｷﾞｮ
ku	ｸ
gu	ｸﾞ
ke	ｹ
ge	ｹﾞ
ko	ｺ
go	ｺﾞ
sa	ｻ
za	ｻﾞ
shi	ｼ
si	ｼ
syi	ｼｨ
she	ｼｪ
sye	ｼｪ
sha	ｼｬ
sya	ｼｬ
shu	ｼｭ
syu	ｼｭ
sho	ｼｮ
syo	ｼｮ
ji	ｼﾞ
zi	ｼﾞ
zyi	ｼﾞｨ
je	ｼﾞｪ
zye	ｼﾞｪ
ja	ｼﾞｬ
zya	ｼﾞｬ
ju	ｼﾞｭ
zyu	ｼﾞｭ
jo	ｼﾞｮ
zyo	ｼﾞｮ
su	ｽ
zu	ｽﾞ
se	ｾ
ze	ｾﾞ
so	ｿ
zo	ｿﾞ
ta	ﾀ
da	ﾀﾞ
chi	ﾁ
ti	ﾁ
tyi	ﾁｨ
che	ﾁｪ
tye	ﾁｪ
cha	ﾁｬ
tya	ﾁｬ
chu	ﾁｭ
tyu	ﾁｭ
cho	ﾁｮ
tyo	ﾁｮ
di	ﾁﾞ
dyi	ﾁﾞｨ
dye	ﾁﾞｪ
dya	ﾁﾞｬ
dyu	ﾁﾞｭ
dyo	ﾁﾞｮ
q	ｯ
xtu	ｯ
tu	ﾂ
tsa	ﾂｧ
tsi	ﾂｨ
tsu	ﾂ
tse	ﾂｪ
tso	ﾂｫ
du	ﾂﾞ
dza	ﾂﾞｧ
dzi	ﾂﾞｨ
dzu	ﾂﾞ
dze	ﾂﾞｪ
dzo	ﾂﾞｫ
te	ﾃ
thi	ﾃｨ
the	ﾃｪ
tha	ﾃｬ
thu	ﾃｭ
tho	ﾃｮ
de	ﾃﾞ
dhi	ﾃﾞｨ
dhe	ﾃﾞｪ
dha	ﾃﾞｬ
dhu	ﾃﾞｭ
dho	ﾃﾞｮ
to	ﾄ
twa	ﾄｧ
twi	ﾄｨ
twu	ﾄｩ
twe	ﾄｪ
two	ﾄｫ
do	ﾄﾞ
dwa	ﾄﾞｧ
dwi	ﾄﾞｨ
dwu	ﾄﾞｩ
dwe	ﾄﾞｪ
dwo	ﾄﾞｫ
na	ﾅ
ni	ﾆ
nyi	ﾆｨ
nye	ﾆｪ
nya	ﾆｬ
nyu	ﾆｭ
nyo	ﾆｮ
nu	ﾇ
ne	ﾈ
no	ﾉ
ha	ﾊ
ba	ﾊﾞ
pa	ﾊﾟ
hi	ﾋ
hyi	ﾋｨ
hye	ﾋｪ
hya	ﾋｬ
hyu	ﾋｭ
hyo	ﾋｮ
bi	ﾋﾞ
byi	ﾋﾞｨ
bye	ﾋﾞｪ
bya	ﾋﾞｬ
byu	ﾋﾞｭ
byo	ﾋﾞｮ
pi	ﾋﾟ
pyi	ﾋﾟｨ
pye	ﾋﾟｪ
pya	ﾋﾟｬ
pyu	ﾋﾟｭ
pyo	ﾋﾟｮ
fu	ﾌ
hu	ﾌ
fa	ﾌｧ
fi	ﾌｨ
fe	ﾌｪ
fo	ﾌｫ
bu	ﾌﾞ
pu	ﾌﾟ
he	ﾍ
be	ﾍﾞ
pe	ﾍﾟ
ho	ﾎ
bo	ﾎﾞ
po	ﾎﾟ
ma	ﾏ
mi	ﾐ
myi	ﾐｨ
mye	ﾐｪ
mya	ﾐｬ
myu	ﾐｭ
myo	ﾐｮ
mu	ﾑ
me	ﾒ
mo	ﾓ
xya	ｬ
ya	ﾔ
xyu	ｭ
yu	ﾕ
xyo	ｮ
yo	ﾖ
ra	ﾗ
ri	ﾘ
ryi	ﾘｨ
rye	ﾘｪ
rya	ﾘｬ
ryu	ﾘｭ
ryo	ﾘｮ
ru	ﾙ
re	ﾚ
ro	ﾛ
xwa	ﾜ
wa	ﾜ
wi	ｲ
we	ｴ
wo	ｦ
l	ﾝ
xn	ﾝ
v	ｳﾞ
vu	ｳﾞ
va	ｳﾞｧ
vi	ｳﾞｨ
ve	ｳﾞｪ
vo	ｳﾞｫ
xka	ｶ
xke	ｹ
zb	ﾞ
zp	ﾟ
-	ｰ
z;	ﾞ
z:	ﾟ
