m	ん
n	ん
k	っ
g	っ
s	っ
z	っ
j	っ
t	っ
c	っ
d	っ
h	っ
b	っ
p	っ
f	っ
y	っ
r	っ
w	っ
v	っ
xa	ぁ
a	あ
xi	ぃ
i	い
xu	ぅ
u	う
whu	う
wha	うぁ
whi	うぃ
whe	うぇ
who	うぉ
xe	ぇ
e	え
xo	ぉ
o	お
ka	か
ga	が
ki	き
kyi	きぃ
kye	きぇ
kya	きゃ
kyu	きゅ
kyo	きょ
gi	ぎ
gyi	ぎぃ
gye	ぎぇ
gya	ぎゃ
gyu	ぎゅ
gyo	ぎょ
ku	く
gu	ぐ
ke	け
ge	げ
ko	こ
go	ご
sa	さ
za	ざ
shi	し
si	し
syi	しぃ
she	しぇ
sye	しぇ
sha	しゃ
sya	しゃ
shu	しゅ
syu	しゅ
sho	しょ
syo	しょ
ji	じ
zi	じ
zyi	じぃ
je	じぇ
zye	じぇ
ja	じゃ
zya	じゃ
ju	じゅ
zyu	じゅ
jo	じょ
zyo	じょ
su	す
zu	ず
se	せ
ze	ぜ
so	そ
zo	ぞ
ta	た
da	だ
chi	ち
ti	ち
tyi	ちぃ
che	ちぇ
tye	ちぇ
cha	ちゃ
tya	ちゃ
chu	ちゅ
tyu	ちゅ
cho	ちょ
tyo	ちょ
di	ぢ
dyi	ぢぃ
dye	ぢぇ
dya	ぢゃ
dyu	ぢゅ
dyo	ぢょ
l	っ
xtu	っ
tu	つ
du	づ
te	て
thi	てぃ
the	てぇ
tha	てゃ
thu	てゅ
tho	てょ
de	で
dhi	でぃ
dhe	でぇ
dha	でゃ
dhu	でゅ
dho	でょ
to	と
twa	とぁ
twi	とぃ
twu	とぅ
twe	とぇ
two	とぉ
do	ど
dwa	どぁ
dwi	どぃ
dwu	どぅ
dwe	どぇ
dwo	どぉ
na	な
ni	に
nyi	にぃ
nye	にぇ
nya	にゃ
nyu	にゅ
nyo	にょ
nu	ぬ
ne	ね
no	の
ha	は
ba	ば
pa	ぱ
hi	ひ
hyi	ひぃ
hye	ひぇ
hya	ひゃ
hyu	ひゅ
hyo	ひょ
bi	び
byi	びぃ
bye	びぇ
bya	びゃ
byu	びゅ
byo	びょ
pi	ぴ
pyi	ぴぃ
pye	ぴぇ
pya	ぴゃ
pyu	ぴゅ
pyo	ぴょ
fu	ふ
hu	ふ
fa	ふぁ
fi	ふぃ
fe	ふぇ
fo	ふぉ
bu	ぶ
pu	ぷ
he	へ
be	べ
pe	ぺ
ho	ほ
bo	ぼ
po	ぽ
ma	ま
mi	み
myi	みぃ
mye	みぇ
mya	みゃ
myu	みゅ
myo	みょ
mu	む
me	め
mo	も
xya	ゃ
ya	や
xyu	ゅ
yu	ゆ
xyo	ょ
yo	よ
ra	ら
ri	り
ryi	りぃ
rye	りぇ
rya	りゃ
ryu	りゅ
ryo	りょ
ru	る
re	れ
ro	ろ
xwa	ゎ
wa	わ
wi	ゐ
we	ゑ
wo	を
q	ん
xn	ん
v	ゔ
vu	ゔ
va	ゔぁ
vi	ゔぃ
ve	ゔぇ
vo	ゔぉ
xka	ゕ
xke	ゖ
odori	ゝ
odori	ゞ
odori	々
dakuten	゛
handakuten	゜
!	！
"	”
#	＃
$	＄
%	％
&	＆
'	’
(	（
)	）
*	＊
+	＋
,	、
,	，
-	ー
-	－
.	。
.	．
/	・
/	／
//	‥
///	…
0	０
1	１
2	２
3	３
4	４
5	５
6	６
7	７
8	８
9	９
:	：
;	；
<	＜
=	＝
>	＞
?	？
@	＠
[	「
[	［
\	￥
]	」
]	］
^	＾
_	＿
`	‘
{	｛
|	｜
}	｝
~	～
M	ン
N	ン
K	ッ
G	ッ
S	ッ
Z	ッ
J	ッ
T	ッ
C	ッ
D	ッ
H	ッ
B	ッ
P	ッ
F	ッ
Y	ッ
R	ッ
W	ッ
V	ッ
XA	ァ
A	ア
XI	ィ
I	イ
XU	ゥ
U	ウ
WHU	ウ
WHA	ウァ
WHI	ウィ
WHE	ウェ
WHO	ウォ
XE	ェ
E	エ
XO	ォ
O	オ
KA	カ
GA	ガ
KI	キ
KYI	キィ
KYE	キェ
KYA	キャ
KYU	キュ
KYO	キョ
GI	ギ
GYI	ギィ
GYE	ギェ
GYA	ギャ
GYU	ギュ
GYO	ギョ
KU	ク
GU	グ
KE	ケ
GE	ゲ
KO	コ
GO	ゴ
SA	サ
ZA	ザ
SHI	シ
SI	シ
SYI	シィ
SHE	シェ
SYE	シェ
SHA	シャ
SYA	シャ
SHU	シュ
SYU	シュ
SHO	ショ
SYO	ショ
JI	ジ
ZI	ジ
ZYI	ジィ
JE	ジェ
ZYE	ジェ
JA	ジャ
ZYA	ジャ
JU	ジュ
ZYU	ジュ
JO	ジョ
ZYO	ジョ
SU	ス
ZU	ズ
SE	セ
ZE	ゼ
SO	ソ
ZO	ゾ
TA	タ
DA	ダ
CHI	チ
TI	チ
TYI	チィ
CHE	チェ
TYE	チェ
CHA	チャ
TYA	チャ
CHU	チュ
TYU	チュ
CHO	チョ
TYO	チョ
DI	ヂ
DYI	ヂィ
DYE	ヂェ
DYA	ヂャ
DYU	ヂュ
DYO	ヂョ
L	ッ
XTU	ッ
TU	ツ
DU	ヅ
TE	テ
THI	ティ
THE	テェ
THA	テャ
THU	テュ
THO	テョ
DE	デ
DHI	ディ
DHE	デェ
DHA	デャ
DHU	デュ
DHO	デョ
TO	ト
TWA	トァ
TWI	トィ
TWU	トゥ
TWE	トェ
TWO	トォ
DO	ド
DWA	ドァ
DWI	ドィ
DWU	ドゥ
DWE	ドェ
DWO	ドォ
NA	ナ
NI	ニ
NYI	ニィ
NYE	ニェ
NYA	ニャ
NYU	ニュ
NYO	ニョ
NU	ヌ
NE	ネ
NO	ノ
HA	ハ
BA	バ
PA	パ
HI	ヒ
HYI	ヒィ
HYE	ヒェ
HYA	ヒャ
HYU	ヒュ
HYO	ヒョ
BI	ビ
BYI	ビィ
BYE	ビェ
BYA	ビャ
BYU	ビュ
BYO	ビョ
PI	ピ
PYI	ピィ
PYE	ピェ
PYA	ピャ
PYU	ピュ
PYO	ピョ
FU	フ
HU	フ
FA	ファ
FI	フィ
FE	フェ
FO	フォ
BU	ブ
PU	プ
HE	ヘ
BE	ベ
PE	ペ
HO	ホ
BO	ボ
PO	ポ
MA	マ
MI	ミ
MYI	ミィ
MYE	ミェ
MYA	ミャ
MYU	ミュ
MYO	ミョ
MU	ム
ME	メ
MO	モ
XYA	ャ
YA	ヤ
XYU	ュ
YU	ユ
XYO	ョ
YO	ヨ
RA	ラ
RI	リ
RYI	リィ
RYE	リェ
RYA	リャ
RYU	リュ
RYO	リョ
RU	ル
RE	レ
RO	ロ
XWA	ヮ
WA	ワ
WI	ヰ
WE	ヱ
WO	ヲ
Q	ン
XN	ン
V	ヴ
VU	ヴ
VA	ヴァ
VI	ヴィ
VE	ヴェ
VO	ヴォ
XKA	ヵ
XKE	ヶ
ODORI	ヽ
ODORI	ヾ
